********************
*s....**************
*****.**************
*****.**************
*****.**************
***...**************
***.****************
*e..****************
********************